11111111111111111
11111111111111111
11110111111111111
11110111111111111
11110111111111111
11110111111111111
11110100001111111
11110100001111111
11110000001111111
11111100001111111
11111111111111111
11111111111111111
11111111111111111
11111111111111111
11111111111111111
11111111111111111
