11111111111111111
10011111111111111
10010001000111111
11010101010111111
11010101010111111
11010101010100111
11010101010100011
11010101010111011
11010101010100011
11010101010101111
11010101010100011
11010101010111011
11010101010100011
11010101010101111
11000100010001111
11111111111111111
