11111111111111111
11111111111111111
11111011111111111
11111000011111111
11111111001111111
11111000100111111
11111011010111111
11111000000111111
11111111111111111
11111111111111111
11111111111111111
11111111111111111
11111111111111111
11111111111111111
11111111111111111
11111111111111111
