11111111111111111
11111111000011111
11111111011001111
11000011011101111
11101010001101111
11100011101101111
11110000100000111
11110101100100111
11110111001001111
11110010101011111
11111001101011111
11111100000010111
11111111000110111
11111111101100111
11111111100001111
11111111111111111
