11111111111111111
11111111101111111
11100011001111111
11100000000111111
11000000000111111
11100111001111111
11110111001111111
11110000000111111
11100000000111111
11110011001111111
11111111111111111
11111111111111111
11111111111111111
11111111111111111
11111111111111111
11111111111111111
