11111111111111111
11111111111111111
11111111001111111
11110000000001111
11111111001101111
11111111111101111
11111111111000111
11111111111000111
11111111111101111
11111111111101111
11111111111101111
11111111111111111
11111111111111111
11111111111111111
11111111111111111
11111111111111111
