11111111111111111
11111111111111111
11111111111111111
11111111111111111
11110000111101111
11110110000000111
10000110011000111
10110001100101111
10111001000111111
10100100010011111
10000110011011111
11111001111011111
11111000000011111
11111111111111111
11111111111111111
11111111111111111
