11111111111111111
11111111111111111
11111111111111111
11001000010001111
11100011000101111
11111111111101111
11100011000101111
11101000010001111
11101111101111111
11101111101111111
11100000001111111
11111111111111111
11111111111111111
11111111111111111
11111111111111111
11111111111111111
