11111111111111111
11111111111111111
11111111111111111
11111111111111111
11111111111111111
11111111111111111
11100000011111111
11111111011111111
11111111011111111
11111110001111111
11111111011111111
11111111010111111
11111111000000111
11111111110111111
11111111111111111
11111111111111111
