11111111111111111
11111111111111111
11111111101011111
11110000010101111
11110000001011111
11101101101101111
11101000100011111
11101010101011111
11101110101011111
11101000100011111
11101111101111111
11100000001111111
11111111111111111
11111111111111111
11111111111111111
11111111111111111
