11111111111111111
11111111111111111
11111110111111111
11111110111111111
11111110111111111
11111110111111111
11111100011111111
11111100011111111
11111110111111111
11111110111111111
11111110111111111
11111110111111111
11111111111111111
11111111111111111
11111111111111111
11111111111111111
