11111111111111111
11111111111111111
11111111111111111
11111101111111111
11111101111111111
11111101111111111
11111101111111111
11111100000011111
11111101101011111
11111110001011111
11111111101011111
11111111111111111
11111111111111111
11111111111111111
11111111111111111
11111111111111111
