11111111111111111
11111111111111111
11111111111111111
11111111111111111
11111110011111111
11111100001111111
11111000000111111
11111000000111111
11111100001111111
11111110011111111
11111111111111111
11111111111111111
11111111111111111
11111111111111111
11111111111111111
11111111111111111
